Script started on 2020-04-11 14:15:34-0700
edwardw@linux-05:~/csci241/lab-1-William-Garrett-Edwards$ git chech[Kkour[Kt -b is[K[Kquestion 3[K[K[K[K[K[K[K[K[K[K"question3"
Switched to a new branch 'question3'
edwardw@linux-05:~/csci241/lab-1-William-Garrett-Edwards$ nanio[K[Ko writeup.txt 
[?1049h[22;0;0t[1;41r(B[m[4l[?7h[39;49m[?1h=[?1h=[?1h=[?25l[39;49m(B[m[H[2J[39;58H(B[0;7m[ Reading File ](B[m[39;64H(B[0;7m 2 lines ](B[m[H(B[0;7m  GNU nano 2.9.3                                              writeup.txt                                                         [1;129H(B[m[40d(B[0;7m^G(B[m Get Help     (B[0;7m^O(B[m Write Out    (B[0;7m^W(B[m Where Is     (B[0;7m^K(B[m Cut Text     (B[0;7m^J(B[m Justify[81G(B[0;7m^C(B[m Cur Pos[97G(B[0;7mM-U(B[m Undo[40;113H(B[0;7mM-A(B[m Mark Text[41d(B[0;7m^X(B[m Exit[41;17H(B[0;7m^R(B[m Read File    (B[0;7m^\(B[m Replace[49G(B[0;7m^U(B[m Uncut Text   (B[0;7m^T(B[m To Spell     (B[0;7m^_(B[m Go To Line   (B[0;7mM-E(B[m Redo[41;113H(B[0;7mM-6(B[m Copy Text[39d[3d[39;49m(B[m1) William Edwards[4d2) Hobby: Soccer[A[?12l[?25h[?25l[4d[?12l[?25h[?25l[5d[?12l[?25h[?25l[1;121H(B[0;7mModified(B[m[5d3[?12l[?25h[?25l)[?12l[?25h[?25l [?12l[?25h[?25lF[?12l[?25h[?25la[?12l[?25h[?25lc[?12l[?25h[?25lv[?12l[?25h[?25l [?12l[?25h[?25l [?12l[?25h[?25lv[?12l[?25h[?25lo[?12l[?25h[?25lr[?12l[?25h[?25li[?12l[?25h[?25lt[?12l[?25h[?25le[?12l[?25h[?25l [?12l[?25h[?25lS[?12l[?25h[?25l [?12l[?25h[?25ls[?12l[?25h[?25lo[?12l[?25h[?25ln[?12l[?25h[?25lg[?12l[?25h[?25l:[?12l[?25h[?25l[39d[K[5;19H[?12l[?25h[?25lH[?12l[?25h[?25lo[?12l[?25h[?25ll[?12l[?25h[?25l,[?12l[?25h[?25l [?12l[?25h[?25ly[?12l[?25h[?25l [?12l[?25h[?25lb[?12l[?25h[?25ly[?12l[?25h[?25l [?12l[?25h[?25lP[?12l[?25h[?25lV[?12l[?25h[?25lI[?12l[?25h[?25l [?12l[?25h[?25lR[?12l[?25h[?25lI[?12l[?25h[?25lS[?12l[?25h[?25l[40;17H[16X[40;33H(B[0;7mM-D(B[m DOS Format[18X[40;65H(B[0;7mM-A(B[m Append[81G          [40;99H(B[0;7mB(B[m Backup File[K[41;2H(B[0;7mC(B[m Cancel[17G[16X[41;33H(B[0;7mM-M(B[m Mac Format[18X[41;65H(B[0;7mM-P(B[m Prepend[21X[41;97H(B[0;7m^T(B[m To Files[K[39d(B[0;7mFile Name to Write: writeup.txt                                                                                                   [39;1H(B[m[39;32H[?12l[?25h[?25l[K[1;129H[1;121H(B[0;7m        (B[m[39;57H(B[0;7m[ Wrote 3 lines ](B[m[40;17H(B[0;7m^O(B[m Write Out    (B[0;7m^W(B[m Where Is     (B[0;7m^K(B[m Cut Text     (B[0;7m^J(B[m Justify[81G(B[0;7m^C(B[m Cur Pos[40;99H(B[0;7mU(B[m Undo        (B[0;7mM-A(B[m Mark Text[41;2H(B[0;7mX(B[m Exit  [17G(B[0;7m^R(B[m Read File    (B[0;7m^\(B[m Replace      (B[0;7m^U(B[m Uncut Text   (B[0;7m^T(B[m To Spell     (B[0;7m^_(B[m Go To Line   (B[0;7mM-E(B[m Redo        (B[0;7mM-6(B[m Copy Text[39d[5;32H[?12l[?25h[?25l[39d[J[41;130H[?12l[?25h[41;1H[?1049l[23;0;0t[?1l>edwardw@linux-05:~/csci241/lab-1-William-Garrett-Edwards$ git commit -a -m
error: switch `m' requires a value
usage: git commit [<options>] [--] <pathspec>...

    -q, --quiet           suppress summary after successful commit
    -v, --verbose         show diff in commit message template

Commit message options
    -F, --file <file>     read message from file
    --author <author>     override author for commit
    --date <date>         override date for commit
    -m, --message <message>
                          commit message
    -c, --reedit-message <commit>
                          reuse and edit message from specified commit
    -C, --reuse-message <commit>
                          reuse message from specified commit
    --fixup <commit>      use autosquash formatted message to fixup specified commit
    --squash <commit>     use autosquash formatted message to squash specified commit
    --reset-author        the commit is authored by me now (used with -C/-c/--amend)
    -s, --signoff         add Signed-off-by:
    -t, --template <file>
                          use specified template file
    -e, --edit            force edit of commit
    --cleanup <default>   how to strip spaces and #comments from message
    --status              include status in commit message template
    -S, --gpg-sign[=<key-id>]
                          GPG sign commit

Commit contents options
    -a, --all             commit all changed files
    -i, --include         add specified files to index for commit
    --interactive         interactively add files
    -p, --patch           interactively add changes
    -o, --only            commit only specified files
    -n, --no-verify       bypass pre-commit and commit-msg hooks
    --dry-run             show what would be committed
    --short               show status concisely
    --branch              show branch information
    --ahead-behind        compute full ahead/behind values
    --porcelain           machine-readable output
    --long                show status in long format (default)
    -z, --null            terminate entries with NUL
    --amend               amend previous commit
    --no-post-rewrite     bypass post-rewrite hook
    -u, --untracked-files[=<mode>]
                          show untracked files, optional modes: all, normal, no. (Default: all)

edwardw@linux-05:~/csci241/lab-1-William-Garrett-Edwards$ git commit -a -m[K[K[K[K[K-m "Cre[K[K[KAdd part 3 to writup.txt"
On branch question3
Changes not staged for commit:
	[31mmodified:   writeup.txt[m

Untracked files:
	[31mtypescript[m

no changes added to commit
edwardw@linux-05:~/csci241/lab-1-William-Garrett-Edwards$ vim index[K[K[K[K[Kwriteup.txt 
[?2004h[?1049h[22;0;0t[?1h=[?2004h[1;41r[?12h[?12l[27m[23m[29m[m[H[2J[?25l[41;1H"writeup.txt" 3L, 70C[2;1H▽[6n[2;1H  [1;1H[>c]10;?]11;?[1;1H1) William Edwards
2) Hobby: Soccer
3) Favorite song: Holy by PVRIS
[1m[34m~                                                                                                                                 [5;1H~                                                                                                                                 [6;1H~                                                                                                                                 [7;1H~                                                                                                                                 [8;1H~                                                                                                                                 [9;1H~                                                                                                                                 [10;1H~                                                                                                                                 [11;1H~                                                                                                                                 [12;1H~                                                                                                                                 [13;1H~                                                                                                                                 [14;1H~                                                                                                                                 [15;1H~                                                                                                                                 [16;1H~                                                                                                                                 [17;1H~                                                                                                                                 [18;1H~                                                                                                                                 [19;1H~                                                                                                                                 [20;1H~                                                                                                                                 [21;1H~                                                                                                                                 [22;1H~                                                                                                                                 [23;1H~                                                                                                                                 [24;1H~                                                                                                                                 [25;1H~                                                                                                                                 [26;1H~                                                                                                                                 [27;1H~                                                                                                                                 [28;1H~                                                                                                                                 [29;1H~                                                                                                                                 [30;1H~                                                                                                                                 [31;1H~                                                                                                                                 [32;1H~                                                                                                                                 [33;1H~                                                                                                                                 [34;1H~                                                                                                                                 [35;1H~                                                                                                                                 [36;1H~                                                                                                                                 [37;1H~                                                                                                                                 [38;1H~                                                                                                                                 [39;1H~                                                                                                                                 [40;1H~                                                                                                                                 [m[41;113H1,1[11CAll[1;1H[?25h[?25l[41;103H^X[1;1H[41;103H  [1;1H0[?25h[?25l[41;103H^M[1;1H[41;103H  [2;1H[41;113H2[2;1H[?25h[?25l[41;103H^M[2;1H[41;103H  [3;1H[41;113H3[3;1H[?25h[?25l[41;103H^M[3;1H[41;103H  [3;1H[?25h[?25l[41;103H^M[3;1H[41;103H  [3;1H[?25h[?25l[41;103H~@k[3;1H[41;103H   [2;1H[41;113H2[2;1H[?25h[?25l[41;103H~@k[2;1H[41;103H   [1;1H[41;113H1[1;1H[?25h[?25l[41;103H~@k[1;1H[41;103H   [1;1H[?25h[?25l[41;103H1[1;1H[?25h[?25l[41;104H^[[1;1H[41;104H  [1;1H[41;104H^[[1;1H[41;103H   [1;1H[?25h[?25l[41;103H^[[1;1H[41;103H  [1;1H[41;103H^[[1;1H[41;103H  [1;1H[?25h[?25l[41;103H^Z[1;1H[41;1H
[?2004l[?1l>[?25h[?1049l[23;0;0t[?2004l
[1]+  Stopped                 vim writeup.txt
edwardw@linux-05:~/csci241/lab-1-William-Garrett-Edwards$ gfi[K[K[Kgit [12@vim writeup.tx[C[Cgit commit -m "Add part 3 to writup.txt"[C[1@ [1@-[1@a[C[1@ [1P[C
[question3 8bb056a] Add part 3 to writup.txt
 1 file changed, 1 insertion(+)
edwardw@linux-05:~/csci241/lab-1-William-Garrett-Edwards$ git chge[K[Keckout master
Switched to branch 'master'
Your branch is up to date with 'origin/master'.
edwardw@linux-05:~/csci241/lab-1-William-Garrett-Edwards$ git merge i[Kquestion3
Updating b239113..8bb056a
Fast-forward
 writeup.txt | 1 [32m+[m
 1 file changed, 1 insertion(+)
edwardw@linux-05:~/csci241/lab-1-William-Garrett-Edwards$ git add writeup.txt 
edwardw@linux-05:~/csci241/lab-1-William-Garrett-Edwards$ comm[K[K[K[Kgit commit we[Kriteup.txt "Added part 3 to writeup.txt"
error: pathspec 'Added part 3 to writeup.txt' did not match any file(s) known to git.
edwardw@linux-05:~/csci241/lab-1-William-Garrett-Edwards$ git commit writeup.txt "Added part 3 to writeup.txt"[K[K[K[K[K[K[K[K[K[K[K[K[K[K[K[K[K[K[K[K[K[K[K[K[K[K[K[K[K[K[K[K[K[K[K[K[K[K[K[K[K-m w[K[K[K[K[K[K[K[K[K[K[Kpush
Username for 'https://github.com': edwar     William-Garrett-Edwards
Password for 'https://William-Garrett-Edwards@github.com': 
Counting objects: 3, done.
Delta compression using up to 8 threads.
Compressing objects:  33% (1/3)   Compressing objects:  66% (2/3)   Compressing objects: 100% (3/3)   Compressing objects: 100% (3/3), done.
Writing objects:  33% (1/3)   Writing objects:  66% (2/3)   Writing objects: 100% (3/3)   Writing objects: 100% (3/3), 333 bytes | 333.00 KiB/s, done.
Total 3 (delta 1), reused 0 (delta 0)
remote: Resolving deltas:   0% (0/1)[Kremote: Resolving deltas: 100% (1/1)[Kremote: Resolving deltas: 100% (1/1), completed with 1 local object.[K
To https://github.com/csci241-20s/lab-1-William-Garrett-Edwards
   b239113..8bb056a  master -> master
edwardw@linux-05:~/csci241/lab-1-William-Garrett-Edwards$ che[K[K[Kgit checout question3
git: 'checout' is not a git command. See 'git --help'.

The most similar command is
	checkout
edwardw@linux-05:~/csci241/lab-1-William-Garrett-Edwards$ get[K[Kit checkoutr[K question3
Switched to branch 'question3'
edwardw@linux-05:~/csci241/lab-1-William-Garrett-Edwards$ git barnach -d question3
git: 'barnach' is not a git command. See 'git --help'.

The most similar command is
	branch
edwardw@linux-05:~/csci241/lab-1-William-Garrett-Edwards$ git barnach -d question3[1P[1P[1@r[1@a[C[C[1P
error: Cannot delete branch 'question3' checked out at '/home/edwardw/csci241/lab-1-William-Garrett-Edwards'
edwardw@linux-05:~/csci241/lab-1-William-Garrett-Edwards$ git branch -d question3[K[K[K[K[K[K[K[K[K[K[K[K[K[K[K[K[K[K[K[K checkour[Kt master
Switched to branch 'master'
Your branch is up to date with 'origin/master'.
edwardw@linux-05:~/csci241/lab-1-William-Garrett-Edwards$ git bnr[K[Krcheckout masterbranch -d question3
Deleted branch question3 (was 8bb056a).
edwardw@linux-05:~/csci241/lab-1-William-Garrett-Edwards$ gradle build

Welcome to Gradle 6.1!

Here are the highlights of this release:
 - Dependency cache is relocatable
 - Configurable compilation order between Groovy, Java & Scala
 - New sample projects in Gradle's documentation

For more details see https://docs.gradle.org/6.1/release-notes.html

Starting a Gradle Daemon (subsequent builds will be faster)


[2A[1B[1m> Starting Daemon[m[17D[1B[1A> IDLE[0K[6D[1B[2A[1m<[0;1m-------------> 0% INITIALIZING [22ms][m[38D[2B[2A[1m<[0;1m-------------> 0% INITIALIZING [122ms][m[39D[1B[1m> Evaluating settings[m[21D[1B[2A[1m<[0;1m-------------> 0% INITIALIZING [222ms][m[39D[2B[2A[1m<[0;1m-------------> 0% INITIALIZING [322ms][m[39D[2B[2A[1m<[0;1m-------------> 0% INITIALIZING [422ms][m[39D[2B[2A[1m<[0;1m-------------> 0% INITIALIZING [522ms][m[39D[2B[2A[1m<[0;1m-------------> 0% INITIALIZING [622ms][m[39D[1B[1m> Evaluating settings > Compiling /home/edwardw/csci241/lab-1-William-Garrett-Edwards/settings.gradle into local compilation cach[m[129D[1B[2A[1m<[0;1m-------------> 0% INITIALIZING [722ms][m[39D[2B[2A[1m<[0;1m-------------> 0% INITIALIZING [822ms][m[39D[2B[2A[1m<[0;1m-------------> 0% INITIALIZING [922ms][m[39D[1B[1m> Evaluating settings[m[0K[21D[1B[2A[1m<[0;1m-------------> 0% CONFIGURING [1s][m[0K[35D[1B[1m> Loading projects[m[0K[18D[1B[1A[1m> root project[m[0K[14D[1B[1A[1m> root project > Compiling /home/edwardw/csci241/lab-1-William-Garrett-Edwards/build.gradle into local compilation cache > Compil[m[129D[1B[1A[1m> root project[m[0K[14D[1B[2A[1m<[0;32;1m=============[0;39;1m> 100% CONFIGURING [1s][m[37D[1B> IDLE[0K[6D[1B[2A[1m<[0;32;1m=============[0;39;1m> 100% CONFIGURING [2s][m[37D[2B[2A[1m<[0;1m-------------> 0% EXECUTING [2s][m[0K[33D[2B[1A[1m> :compileJava[m[14D[1B[1A[1m> :compileJava > Resolve dependencies of :compileClasspath[m[58D[1B[1A[1m> :compileJava > Resolve dependencies of :compileClasspath > guava-26.0-jre.pom[m[79D[1B[2A[1m<[0;1m-------------> 0% EXECUTING [3s][m[33D[1B[1m> :compileJava > Resolve dependencies of :compileClasspath[m[0K[58D[1B[1A[1m> :compileJava > Resolve dependencies of :compileClasspath > oss-parent-9.pom[m[77D[1B[1A[1m> :compileJava > Resolve dependencies of :compileClasspath[m[0K[58D[1B



[5A[1m> :compileJava > Resolve dependencies of :compileClasspath > jsr305-3.0.2.pom[m[77D[1B[1m> :compileJava > Resolve dependencies of :compileClasspath > checker-qual-2.5.2.pom[m[83D[1B[1m> :compileJava > Resolve dependencies of :compileClasspath > j2objc-annotations-1.1.pom[m[87D[1B[1m> :compileJava > Resolve dependencies of :compileClasspath > error_prone_parent-2.1.3.pom[m[89D[1B[1m> :compileJava > Resolve dependencies of :compileClasspath > animal-sniffer-parent-1.14.pom[m[91D[1B[5A> IDLE[0K[6D[1B> IDLE[0K[6D[1B> IDLE[0K[6D[1B[1m> :compileJava > Resolve dependencies of :compileClasspath[m[0K[58D[1B> IDLE[0K[6D[1B[2A[1m> :compileJava > Resolve files of :compileClasspath[m[0K[51D[2B[2A[1m> :compileJava[m[0K[14D[2B[6A[1m<[0;1m-------------> 0% EXECUTING [4s][m[33D[6B[6A[1m<[0;1m-------------> 0% EXECUTING [5s][m[33D[6B[6A[1m<[0;1m-------------> 0% EXECUTING [6s][m[33D[6B[6A[1m<[0;1m-------------> 0% EXECUTING [7s][m[33D[6B[6A[1m<[0;32;1m===[0;39;1m----------> 28% EXECUTING [7s][m[34D[4B[1m> :startScripts[m[15D[2B[6A[1m<[0;32;1m====[0;39;1m---------> 35% EXECUTING [8s][m[34D[4B[1m> :distTar[m[0K[10D[2B[6A[1m<[0;32;1m=====[0;39;1m--------> 42% EXECUTING [8s][m[34D[4B[1m> :distZip[m[10D[2B[6A[1m<[0;32;1m=============[0;39;1m> 100% EXECUTING [8s][m[35D[4B> IDLE[0K[6D[2B[6A[0K
[32;1mBUILD SUCCESSFUL[0;39m in 10s
5 actionable tasks: 5 executed
[3B[0K
[0K
[0K
[6A[1m<[0;1m-------------> 0% WAITING[m[26D[1B> IDLE[6D[1B> IDLE[6D[1B> IDLE[6D[1B> IDLE[6D[1B> IDLE[6D[1B[6A[2K[1B[2K[1B[2K[1B[2K[1B[2K[1B[2K[5A[0m[?12l[?25hedwardw@linux-05:~/csci241/lab-1-William-Garrett-Edwards$ grade[Kle run


[2A[1m<[0;1m-------------> 0% EXECUTING [99ms][m[35D[1B[1m> :compileJava > Resolve dependencies of :compileClasspath[m[58D[1B[2A[1m<[0;32;1m=========[0;39;1m----> 75% EXECUTING [199ms][m[37D[1B[1m> :run[m[0K[6D[1B[2A[0K
[1m> Task :run[m
Hello, world!

[32;1mBUILD SUCCESSFUL[0;39m in 731ms
2 actionable tasks: 1 executed, 1 up-to-date
[0K
[0K
[2A[1m<[0;1m-------------> 0% WAITING[m[26D[1B[1m> :run[m[6D[1B[2A[2K[1B[2K[1A[0m[?12l[?25hedwardw@linux-05:~/csci241/lab-1-William-Garrett-Edwards$ ls
build  build.gradle  gradle  settings.gradle  src  typescript  username.txt  writeup.txt
edwardw@linux-05:~/csci241/lab-1-William-Garrett-Edwards$ cd sc[Krc/main/java/lab1/Hello.java [K[K[K[K[K[K[K[K[K[K[K
edwardw@linux-05:~/csci241/lab-1-William-Garrett-Edwards/src/main/java/lab1$ nano la[K[KHello.java 
[?1049h[22;0;0t[1;41r(B[m[4l[?7h[39;49m[?1h=[?1h=[?1h=[?25l[39;49m(B[m[H[2J[39;58H(B[0;7m[ Reading File ](B[m[39;64H(B[0;7m 7 lines ](B[m[H(B[0;7m  GNU nano 2.9.3                                               Hello.java                                                         [1;129H(B[m[40d(B[0;7m^G(B[m Get Help     (B[0;7m^O(B[m Write Out    (B[0;7m^W(B[m Where Is     (B[0;7m^K(B[m Cut Text     (B[0;7m^J(B[m Justify[81G(B[0;7m^C(B[m Cur Pos[97G(B[0;7mM-U(B[m Undo[40;113H(B[0;7mM-A(B[m Mark Text[41d(B[0;7m^X(B[m Exit[41;17H(B[0;7m^R(B[m Read File    (B[0;7m^\(B[m Replace[49G(B[0;7m^U(B[m Uncut Text   (B[0;7m^T(B[m To Spell     (B[0;7m^_(B[m Go To Line   (B[0;7mM-E(B[m Redo[41;113H(B[0;7mM-6(B[m Copy Text[39d[3d[39;49m[36mpackage[39m(B[m lab1;[5d[36mpublic[39m(B[m [36mclass[39m(B[m Hello {[6;3H[36mpublic[39m(B[m [36mstatic[39m(B[m [32mvoid[39m(B[m main(String[] args) {[7;5HSystem.out.println([31m"Hello, world!"[39m(B[m);[8;3H}[9d}[3d[?12l[?25h[?25l[4d[?12l[?25h[?25l[5d[?12l[?25h[?25l[6d[?12l[?25h[?25l [?12l[?25h[?25l [?12l[?25h[?25l[C[?12l[?25h[?25l[C[?12l[?25h[?25l[C[?12l[?25h[?25l[C[?12l[?25h[?25l[C[?12l[?25h[?25l[C[?12l[?25h[?25l [?12l[?25h[?25l[C[?12l[?25h[?25l[C[?12l[?25h[?25l[C[?12l[?25h[?25l[C[?12l[?25h[?25l[C[?12l[?25h[?25l[C[?12l[?25h[?25l [?12l[?25h[?25l[C[?12l[?25h[?25l[C[?12l[?25h[?25l[C[?12l[?25h[?25l[C[?12l[?25h[?25l [?12l[?25h[?25lm[?12l[?25h[?25l[39d[K[6;24H[?12l[?25h[?25li[?12l[?25h[?25ln[?12l[?25h[?25l([?12l[?25h[?25lS[?12l[?25h[?25lt[?12l[?25h[?25lr[?12l[?25h[?25li[?12l[?25h[?25ln[?12l[?25h[?25lg[?12l[?25h[?25l[[?12l[?25h[?25l][?12l[?25h[?25l [?12l[?25h[?25la[?12l[?25h[?25lr[?12l[?25h[?25l[7d[?12l[?25h[?25l[?12l[?25h[?25l[C[?12l[?25h[?25l[1;121H(B[0;7mModified(B[m[7;37H[31m"[39m(B[m);[K[?12l[?25h[?25l[31m"[39m(B[m);[K[?12l[?25h[?25l[31m"[39m(B[m);[K[?12l[?25h[?25l[31m"[39m(B[m);[K[?12l[?25h[?25l[31m"[39m(B[m);[K[?12l[?25h[?25l[31m"[39m(B[m);[K[?12l[?25h[?25l[31m"[39m(B[m);[K[?12l[?25h[?25l[31m "[39m(B[m);[?12l[?25h[?25l[C[?12l[?25h[?25l+);[?12l[?25h[?25la);[?12l[?25h[?25lr);[?12l[?25h[?25ls);[?12l[?25h[?25l);[K[?12l[?25h[?25lg);[?12l[?25h[?25ls);[?12l[?25h[?25l{);[?12l[?25h[?25l);[K[?12l[?25h[?25l[);[?12l[?25h[?25l0);[?12l[?25h[?25l]);[?12l[?25h[?25l)[?12l[?25h[?25l[40;17H[16X[40;33H(B[0;7mM-D(B[m DOS Format[18X[40;65H(B[0;7mM-A(B[m Append[81G          [40;99H(B[0;7mB(B[m Backup File[K[41;2H(B[0;7mC(B[m Cancel[17G[16X[41;33H(B[0;7mM-M(B[m Mac Format[18X[41;65H(B[0;7mM-P(B[m Prepend[21X[41;97H(B[0;7m^T(B[m To Files[K[39d(B[0;7mFile Name to Write: Hello.java                                                                                                    [39;1H(B[m[39;31H[?12l[?25h[?25l[K[1;129H[1;121H(B[0;7m        (B[m[39;57H(B[0;7m[ Wrote 7 lines ](B[m[40;17H(B[0;7m^O(B[m Write Out    (B[0;7m^W(B[m Where Is     (B[0;7m^K(B[m Cut Text     (B[0;7m^J(B[m Justify[81G(B[0;7m^C(B[m Cur Pos[40;99H(B[0;7mU(B[m Undo        (B[0;7mM-A(B[m Mark Text[41;2H(B[0;7mX(B[m Exit  [17G(B[0;7m^R(B[m Read File    (B[0;7m^\(B[m Replace      (B[0;7m^U(B[m Uncut Text   (B[0;7m^T(B[m To Spell     (B[0;7m^_(B[m Go To Line   (B[0;7mM-E(B[m Redo        (B[0;7mM-6(B[m Copy Text[39d[7;42H[?12l[?25h[?25l[39d[J[41;130H[?12l[?25h[41;1H[?1049l[23;0;0t[?1l>edwardw@linux-05:~/csci241/lab-1-William-Garrett-Edwards/src/main/java/lab1$ gnano Hello.java cd src/main/java/lab1/ls[Kgradle run --args="241"


[2A[1m<[0;1m-------------> 0% INITIALIZING [6ms][m[37D[1B[1m> Evaluating settings[m[21D[1B[2A[0K
[31mFAILURE: [39m[31mBuild failed with an exception.[39m

* What went wrong:
Project directory '/home/edwardw/csci241/lab-1-William-Garrett-Edwards/src/main/java/lab1' is not part of the build defined by settings file '/home/edwardw/csci241/lab-1-William-Garrett-Edwards/settings.gradle'. If this is an unrelated build, it must have its own settings file.

* Try:
Run with [1m--stacktrace[m option to get the stack trace. Run with [1m--info[m or [1m--debug[m option to get more log output. Run with [1m--scan[m to get full insights.

* Get more help at [1mhttps://help.gradle.org[m

[31;1mBUILD FAILED[0;39m in 530ms
[0K
[0K
[2A[1m<[0;1m-------------> 0% WAITING[m[26D[1B> IDLE[6D[1B[2A[2K[1B[2K[1A[0m[?12l[?25hedwardw@linux-05:~/csci241/lab-1-William-Garrett-Edwards/src/main/java/lab1$ gradle run --args="241"[7Pnano Hello.java 
[?1049h[22;0;0t[1;41r(B[m[4l[?7h[39;49m[?1h=[?1h=[?1h=[?25l[39;49m(B[m[H[2J[39;58H(B[0;7m[ Reading File ](B[m[39;64H(B[0;7m 7 lines ](B[m[H(B[0;7m  GNU nano 2.9.3                                               Hello.java                                                         [1;129H(B[m[40d(B[0;7m^G(B[m Get Help     (B[0;7m^O(B[m Write Out    (B[0;7m^W(B[m Where Is     (B[0;7m^K(B[m Cut Text     (B[0;7m^J(B[m Justify[81G(B[0;7m^C(B[m Cur Pos[97G(B[0;7mM-U(B[m Undo[40;113H(B[0;7mM-A(B[m Mark Text[41d(B[0;7m^X(B[m Exit[41;17H(B[0;7m^R(B[m Read File    (B[0;7m^\(B[m Replace[49G(B[0;7m^U(B[m Uncut Text   (B[0;7m^T(B[m To Spell     (B[0;7m^_(B[m Go To Line   (B[0;7mM-E(B[m Redo[41;113H(B[0;7mM-6(B[m Copy Text[39d[3d[39;49m[36mpackage[39m(B[m lab1;[5d[36mpublic[39m(B[m [36mclass[39m(B[m Hello {[6;3H[36mpublic[39m(B[m [36mstatic[39m(B[m [32mvoid[39m(B[m main(String[] args) {[7;5HSystem.out.println([31m"Hello, "[39m(B[m+args[0]);[8;3H}[9d}[3d[?12l[?25h[?25l[40;17H[16X[40;33H(B[0;7mM-D(B[m DOS Format[18X[40;65H(B[0;7mM-A(B[m Append[81G          [40;99H(B[0;7mB(B[m Backup File[K[41;2H(B[0;7mC(B[m Cancel[17G[16X[41;33H(B[0;7mM-M(B[m Mac Format[18X[41;65H(B[0;7mM-P(B[m Prepend[21X[41;97H(B[0;7m^T(B[m To Files[K[39d(B[0;7mFile Name to Write: Hello.java                                                                                                    [39;1H(B[m[39;31H[?12l[?25h[?25l[K[1;129H[39;57H(B[0;7m[ Wrote 7 lines ](B[m[40;17H(B[0;7m^O(B[m Write Out    (B[0;7m^W(B[m Where Is     (B[0;7m^K(B[m Cut Text     (B[0;7m^J(B[m Justify[81G(B[0;7m^C(B[m Cur Pos[40;99H(B[0;7mU(B[m Undo        (B[0;7mM-A(B[m Mark Text[41;2H(B[0;7mX(B[m Exit  [17G(B[0;7m^R(B[m Read File    (B[0;7m^\(B[m Replace      (B[0;7m^U(B[m Uncut Text   (B[0;7m^T(B[m To Spell     (B[0;7m^_(B[m Go To Line   (B[0;7mM-E(B[m Redo        (B[0;7mM-6(B[m Copy Text[39d[3d[?12l[?25h[?25l[39d[J[41;130H[?12l[?25h[41;1H[?1049l[23;0;0t[?1l>edwardw@linux-05:~/csci241/lab-1-William-Garrett-Edwards/src/main/java/lab1$ nano Hello.java gradle run --args="241"[C[K[K[K[K[K[K[K[K[K[K[K[K[K[K[K[K[K[K[K[K[K[K[Kgit add Hello.java 
edwardw@linux-05:~/csci241/lab-1-William-Garrett-Edwards/src/main/java/lab1$ git add Hello.java [3Pnano[C[C[C[C[C[C[C[C[C[C[C[C
[?1049h[22;0;0t[1;41r(B[m[4l[?7h[39;49m[?1h=[?1h=[?1h=[?25l[39;49m(B[m[H[2J[39;58H(B[0;7m[ Reading File ](B[m[39;64H(B[0;7m 7 lines ](B[m[H(B[0;7m  GNU nano 2.9.3                                               Hello.java                                                         [1;129H(B[m[40d(B[0;7m^G(B[m Get Help     (B[0;7m^O(B[m Write Out    (B[0;7m^W(B[m Where Is     (B[0;7m^K(B[m Cut Text     (B[0;7m^J(B[m Justify[81G(B[0;7m^C(B[m Cur Pos[97G(B[0;7mM-U(B[m Undo[40;113H(B[0;7mM-A(B[m Mark Text[41d(B[0;7m^X(B[m Exit[41;17H(B[0;7m^R(B[m Read File    (B[0;7m^\(B[m Replace[49G(B[0;7m^U(B[m Uncut Text   (B[0;7m^T(B[m To Spell     (B[0;7m^_(B[m Go To Line   (B[0;7mM-E(B[m Redo[41;113H(B[0;7mM-6(B[m Copy Text[39d[3d[39;49m[36mpackage[39m(B[m lab1;[5d[36mpublic[39m(B[m [36mclass[39m(B[m Hello {[6;3H[36mpublic[39m(B[m [36mstatic[39m(B[m [32mvoid[39m(B[m main(String[] args) {[7;5HSystem.out.println([31m"Hello, "[39m(B[m+args[0]);[8;3H}[9d}[3d[?12l[?25h[?25l[39d[J[41;130H[?12l[?25h[41;1H[?1049l[23;0;0t[?1l>edwardw@linux-05:~/csci241/lab-1-William-Garrett-Edwards/src/main/java/lab1$ nano Hello.java [3@git add[C[C[C[C[C[C[C[C[C[C[C[C[3Pnano[C[C[C[C[C[C[C[C[C[C[C[Cgradle run --args="241"


[2A[1m<[0;1m-------------> 0% INITIALIZING [8ms][m[37D[1B[1m> Evaluating settings[m[21D[1B[2A[0K
[31mFAILURE: [39m[31mBuild failed with an exception.[39m

* What went wrong:
Project directory '/home/edwardw/csci241/lab-1-William-Garrett-Edwards/src/main/java/lab1' is not part of the build defined by settings file '/home/edwardw/csci241/lab-1-William-Garrett-Edwards/settings.gradle'. If this is an unrelated build, it must have its own settings file.

* Try:
Run with [1m--stacktrace[m option to get the stack trace. Run with [1m--info[m or [1m--debug[m option to get more log output. Run with [1m--scan[m to get full insights.

* Get more help at [1mhttps://help.gradle.org[m

[31;1mBUILD FAILED[0;39m in 565ms
[0K
[0K
[2A[1m<[0;1m-------------> 0% WAITING[m[26D[1B[1m> Evaluating settings[m[21D[1B[2A[2K[1B[2K[1A[0m[?12l[?25hedwardw@linux-05:~/csci241/lab-1-William-Garrett-Edwards/src/main/java/lab1$ gradle run --args="241"[7Pnano Hello.java [3@git add[C[C[C[C[C[C[C[C[C[C[C[C[3Pnano[C[C[C[C[C[C[C[C[C[C[C[Cgradle run --args="241"[7Pnano Hello.java cd src/main/java/lab1/ls[Kgradle runbuild


[2A[1m<[0;1m-------------> 0% INITIALIZING [10ms][m[38D[1B[1m> Evaluating settings[m[21D[1B[2A[0K
[31mFAILURE: [39m[31mBuild failed with an exception.[39m

* What went wrong:
Project directory '/home/edwardw/csci241/lab-1-William-Garrett-Edwards/src/main/java/lab1' is not part of the build defined by settings file '/home/edwardw/csci241/lab-1-William-Garrett-Edwards/settings.gradle'. If this is an unrelated build, it must have its own settings file.

* Try:
Run with [1m--stacktrace[m option to get the stack trace. Run with [1m--info[m or [1m--debug[m option to get more log output. Run with [1m--scan[m to get full insights.

* Get more help at [1mhttps://help.gradle.org[m

[31;1mBUILD FAILED[0;39m in 549ms
[0K
[0K
[2A[1m<[0;1m-------------> 0% WAITING[m[26D[1B[1m> Evaluating settings[m[21D[1B[2A[2K[1B[2K[1A[0m[?12l[?25hedwardw@linux-05:~/csci241/lab-1-William-Garrett-Edwards/src/main/java/lab1$ gradle buildrun --args="241"[7Pnano Hello.java [3@git add[C[C[C[C[C[C[C[C[C[C[C[C[3Pnano[C[C[C[C[C[C[C[C[C[C[C[Cgradle run --args="241"[7Pnano Hello.java cd src/main/java/lab1/ls[Kgradle runbuildit branch -d question3[4Pcheckout masterbranch -d question3[1@arna[C[C[C[C[C[C[C[C[C[C[C[C[C[C[C[2Pcheckout[C[C[C[C[C[C[C[C[C[C[1P[C[C[C[C[C[C[C[C[C[C[C[C[Cpush[Kcommit writeup.txt "Added part 3 to writeup.txt"[32Padd writeup.txt